No,seqnames,start,end,width,strand,value,area,cluster,indexStart,indexEnd,L,clusterL,p.value,fwer,p.valueArea,fwerArea,Seg.38,Start.38,End.38
DMR_1,chr6,30130698,30132226,1528,*,-2.290879416,34.92373031,151423,72097,72122,26,26,0,0,0.0000651391535167,0.016,chr6,30162921,30164449
DMR_2,chr17,46651722,46652501,779,*,-1.471723502,22.90879416,80880,37436,37445,10,10,0,0,0.000700245900304526,0.128,chr17,48574360,48575139
DMR_3,chr5,67583972,67584380,408,*,-1.391496616,14.55432268,142237,66329,66336,8,8,0,0,0.00460859511130653,0.344,chr5,68288144,68288552
DMR_4,chr17,58499679,58499911,232,*,-1.343220396,10.30206451,81953,38120,38126,7,8,0.000179132672170925,0.012,0.0202419919553145,0.66,chr17,60422318,60422550
DMR_5,chr4,1202509,1203001,492,*,-1.327126099,15.92551319,131487,61579,61590,12,14,0.000244271825687625,0.016,0.00301268585014738,0.264,chr4,1208721,1209213
DMR_6,chr7,27142100,27143046,946,*,-1.323204715,17.14104772,162572,82049,82064,16,27,0.000407119709479375,0.032,0.00203559854739688,0.22,chr7,27102481,27103427
DMR_7,chr17,76975944,76976357,413,*,-1.247980305,11.13197293,84008,38973,38980,8,8,0.0005211132281336,0.032,0.0145586008109825,0.588,chr17,78979862,78980275
DMR_8,chr6,32049053,32049856,803,*,-1.241840178,17.21818078,152060,75205,75221,17,19,0.0003908349211002,0.044,0.0020193137590177,0.216,chr6,32081276,32082079
DMR_9,chr17,46669485,46669781,296,*,-1.22485019,9.262433003,80897,37472,37478,7,8,0.00113993518654225,0.052,0.0308596739785366,0.748,chr17,48592123,48592419
DMR_10,chr16,66612955,66613407,452,*,-1.21236274,12.56893854,71457,33387,33397,11,12,0.0017587571449509,0.056,0.00885892487827121,0.456,chr16,66579052,66579504
DMR_11,chr19,58220295,58220837,542,*,-1.210506116,11.80750462,96861,45683,45692,10,10,0.0018890354519843,0.068,0.0114319214421809,0.52,chr19,57708927,57709469
DMR_12,chr6,149805995,149806732,737,*,-1.198867677,11.38288753,157704,80529,80538,10,10,0.00257299656390965,0.068,0.0131743937987526,0.56,chr6,149484859,149485596
DMR_13,chr6,32054441,32055370,929,*,-1.190414991,15.57109581,152066,75237,75253,17,26,0.000749100265442051,0.076,0.00327324246421418,0.268,chr6,32086664,32087593
DMR_14,chr1,155146302,155147431,1129,*,-1.142630776,9.992389849,12396,5745,5752,8,8,0.0021495920660511,0.076,0.0228149885192242,0.688,chr1,155173826,155174955
DMR_15,chr13,47472064,47472349,285,*,-1.138288753,9.983842437,50424,25214,25221,8,9,0.00218216164280945,0.076,0.0229289820378784,0.688,chr13,46897929,46898214
DMR_16,chr19,55549414,55549842,428,*,-1.116459988,9.934721421,96391,45279,45286,8,8,0.00231243994984285,0.076,0.0232383930170827,0.688,chr19,55038046,55038474
DMR_17,chr6,146919932,146920295,363,*,-1.098988012,10.71373492,157559,80489,80497,9,10,0.00257299656390965,0.08,0.0171967365284088,0.628,chr6,146598796,146599159
DMR_18,chr6,32118208,32118457,249,*,-1.091267267,12.08886814,152101,75496,75506,11,12,0.00257299656390965,0.084,0.0105362580813262,0.508,chr6,32150431,32150680
DMR_19,chr17,46622454,46622899,445,*,-1.071315483,9.798801517,80857,37419,37426,8,8,0.00278469881283893,0.088,0.0245737456641751,0.704,chr17,48545092,48545537
DMR_20,chr1,92952581,92953279,698,*,-1.067633363,9.698901922,9723,4018,4025,8,25,0.00309410979204325,0.1,0.0255671177553048,0.712,chr1,92487024,92487722
DMR_21,chr20,62367698,62367998,300,*,-1.059003738,8.473542809,115390,54160,54166,7,8,0.00314296415718078,0.104,0.041965899653134,0.8,chr20,63736346,63736646
DMR_22,chr1,42383900,42384647,747,*,-1.031695144,10.08981899,6972,2408,2416,9,11,0.00413633624831045,0.108,0.0219844643118863,0.676,chr1,41918229,41918976
DMR_23,chr3,21792248,21792991,743,*,-1.024488649,9.590941412,122042,56804,56811,8,8,0.00333838161773088,0.108,0.0268861856140179,0.732,chr3,21750756,21751499
DMR_24,chr1,2983926,2984631,705,*,-1.01841348,9.821405401,1249,247,255,9,11,0.0052762714348527,0.128,0.0243294738384875,0.704,chr1,3067362,3068067
DMR_25,chr6,31543169,31543686,517,*,-1.014414839,11.4290712,151795,73706,73717,12,12,0.00394091878776035,0.14,0.0129789763382025,0.556,chr6,31575392,31575909
DMR_26,chr14,85995726,85996873,1147,*,-1.012834164,12.24462552,57007,28321,28334,14,14,0.00198674418225935,0.156,0.00990115133453841,0.492,chr14,85529382,85530529
DMR_27,chr13,114814024,114814706,682,*,-0.989690517989281,8.931679906,53312,26319,26326,8,8,0.0057973846629863,0.16,0.0350122950152263,0.768,chr13,114048548,114049230
DMR_28,chr6,30039142,30039801,659,*,-0.954310379058998,13.40558886,151374,71898,71913,16,33,0.0018890354519843,0.176,0.00666047844708258,0.424,chr6,30071365,30072024
DMR_29,chr11,1769289,1769645,356,*,-0.952422600215866,8.541066907,29088,13249,13256,8,9,0.00822381813148338,0.212,0.0407608253130751,0.792,chr11,1748059,1748415
DMR_30,chr12,122018770,122019117,347,*,-0.935889121518357,8.540912681,46882,23792,23799,8,15,0.00822381813148338,0.212,0.0407608253130751,0.792,chr12,121580865,121581212
DMR_31,chr17,37123638,37123949,311,*,-0.915946812326252,9.220397845,79186,36385,36393,9,9,0.00801211588255411,0.224,0.0312016545344993,0.752,chr17,38967385,38967696
DMR_32,chr11,94278324,94278603,279,*,-0.907961472743626,8.472029904,36422,17894,17901,8,8,0.00864722262934193,0.224,0.0419984692298924,0.8,chr11,94545158,94545437
DMR_33,chr12,322214,323439,1225,*,-0.874616108447279,12.13544862,39391,19366,19380,15,15,0.00249157262201378,0.232,0.0103734101975345,0.504,chr12,213048,214273
DMR_34,chr17,43324322,43325323,1001,*,-0.83784930353751,9.16572132,80459,37231,37239,9,9,0.00828895728500008,0.236,0.0319344700115622,0.76,chr17,45246955,45247956
DMR_35,chr10,73848764,73849167,403,*,-0.83103425202529,9.129733551,22988,10431,10439,9,9,0.00854951389906688,0.248,0.0323904440861791,0.764,chr10,72089006,72089409
DMR_36,chr19,58399865,58400574,709,*,-0.809029908203969,8.949380927,96887,45725,45733,9,9,0.00946146204830068,0.276,0.0346377448825053,0.768,chr19,57888497,57889206
DMR_37,chr16,85518792,85519308,516,*,-0.789870644518374,8.253561154,73232,34065,34072,8,8,0.0103082710440178,0.276,0.0461185206898236,0.832,chr16,85485186,85485702
DMR_38,chr7,28998069,28998860,791,*,-0.770273711319626,8.907214662,162837,82390,82398,9,22,0.00968944908560913,0.28,0.0353054212060514,0.772,chr7,28958453,28959244
DMR_39,chr17,6679254,6679597,343,*,-0.677236568192217,9.9875762,76153,34773,34783,11,12,0.00786555278714153,0.324,0.0228638428843617,0.688,chr17,6775935,6776278
DMR_40,chr11,67417958,67418365,407,*,-0.638386137274761,9.358891215,34529,16971,16980,10,11,0.00995000569967593,0.332,0.0297360235803736,0.744,chr11,67650487,67650894
DMR_41,chr1,231155695,231156359,664,*,-0.615139751746484,8.588793412,17672,8255,8263,9,12,0.0121158825541062,0.344,0.0399303011057371,0.792,chr1,231019949,231020613
DMR_42,chr18,21718458,21719568,1110,*,-0.596254093145546,11.07251553,86366,39817,39834,18,18,0.00405491230641458,0.444,0.0149982900972202,0.588,chr18,24138494,24139604
DMR_43,chr11,66103386,66104485,1099,*,0.994375658510797,9.481311955,34184,16721,16734,14,14,0.00723044604035371,0.484,0.0281401143192144,0.736,chr11,66335915,66337014
DMR_44,chr14,24780167,24780926,759,*,1.067614085,8.68857709,54091,26801,26811,11,13,0.0169687494911004,0.524,0.0384809549399906,0.788,chr14,24310961,24311720
DMR_45,chr6,32078127,32078624,497,*,1.121090999,8.31034252,152082,75347,75356,10,10,0.0192160502874265,0.536,0.0449948702916606,0.816,chr6,32110350,32110847
DMR_46,chr6,33084554,33085063,509,*,1.180750462,9.575792059,152369,76461,76475,15,18,0.00731186998224958,0.548,0.0270327487094305,0.732,chr6,33116777,33117286
DMR_47,chr7,27224873,27225485,612,*,1.249048731,9.54006549,162657,82271,82286,16,34,0.00701874379142443,0.564,0.0275050075724266,0.732,chr7,27185254,27185866
DMR_48,chr6,30859977,30860497,520,*,1.819290335,8.473010825,151612,73198,73208,11,15,0.0190043480384972,0.572,0.041965899653134,0.8,chr6,30892200,30892720
